ошибка: ошибка
страницы: страница
сайте: сайт
существует: существовать
расстраивайтесь: расстраиваться
попробуйте: попробовать
воспользоваться: воспользоваться
другими: другой
разделами: раздел
нашего: наш
сайта: сайт
генератор: генератор
случайных: случайный
книг: книга
рейтинг: рейтинг
лучших: хороший
самые: самый
популярные: популярный
обсуждения: обсуждение
последние: последний
рецензии: рецензия
книги: книга
цитаты: цитата
уверены: уверить
набрали: набрать
правильный: правильный
адрес: адрес
напишите: написать
почту: почта почесть почтить
забудьте: забыть
указать: указать
ссылку: ссылка
страницу: страница
которой: который
перешли: переслать перейти
ошибкой: ошибка
искра: искра
ветер: ветер
автор: автор
алексей: алексей
пехов: пех
год: год
написания: написание
серия: серия
искры: искра
книга: книга
жанры: жанр
боевое: боевой
фэнтези: фэнтези
волшебников: волшебник
описание: описание
суровая: суровый
зима: зима
исходе: исход
южный: южный
гор: гора гор
несет: нести
своем: свой
хвосте: хвост
перемены: перемена
добру: добро
пламя: пламя
войны: война
пылает: пылать
равнинами: равнина
городами: город
севера: север
армии: армия
проклятых: проклятый проклясть
рвутся: рваться
корунну: корунн корунна
хребтам: хребет
заиндевевших: заиндеветь
сквозь: сквозь
ядовитый: ядовитый
туман: туман
оставленных: оставить
болот: болото
горький: горький
пепел: пепел
брагун: брагун
зана: зана зать зан заный
пустынным: пустынный
красным: красный красное
холмам: холм
мимо: мимо
выжженных: выжечь
городов: город городов
деревень: деревня
те: тот ты
кого: кто
называют: называть
искателями: искатель
ветра: ветер
должны: должный
дойти: дойти
последней: последний
черты: черта
предстоит: предстоять
решить: решить
важнее: важный
мире: мир миро
хары: хара
любовь: любовь
оценок: оценка
купить: купить
книгу: книга
р: р
скачать: скачать
интересные: интересный
факты: факт
одно: один
могу: мочь
сказать: сказать
тебе: ты
точно: точно точный
эта: этот
история: история
подошла: подойти
концу: конец
будут: быть
другие: другой
бывай: бывать
серый: серый
держись: держаться
выведет: вывести
гаррет: гаррет
добавил: добавить
сильнее: сильный
любви: любовь
магии: магия
источник: источник
сущего: сущий
освоит: освоить
это: это этот
чувство: чувство
остатка: остаток
открываются: открываться
воистину: воистину
грандиозные: грандиозный
перспективы: перспектива
её: её она
спасла: спасти
твоя: твой
всесилен: всесильный
приходится: приходиться
придумывать: придумывать
ограничения: ограничение
мира: мир миро
иначе: иначе
жизнь: жизнь
теряет: терять
всякий: всякий
смысл: смысл
любое: любой
мгновение: мгновение
достать: достать
луну: луна
небес: небо
книгой: книга
читают: читать
полыни: полынь
поиск: поиск
внучка: внучка внучок внучек
бабы: баба
яги: яга
добыча: добыча
одинокая: одинокий
блондинка: блондинка
желает: желать
познакомить: познакомить
отзывы: отзыв
последнее: последний
популярное: популярный
новое: новый новое
алена: ален алёна
написала: написать
рецензию: рецензия
января: январь
пойманный: поймать
хвост: хвост
таки: таки
донес: донести
ох: ох
наших: наш
героев: герой
пушинки: пушинка
оставляет: оставлять
время: время
покое: покой
порывами: порыв
кидает: кидать
стороны: сторона
сторону: сторона
всё: всё весь
равно: равно равный
вперед: вперёд
показалась: показаться
намного: намного
динамичнее: динамичный
третьей: третий
неожиданных: неожиданный
малоожидаемых: малоожидать
моментов: момент
хватало: хватать
хотя: хотя хотеть
несколько: несколько
трагичных: трагичный
терялись: теряться
фоне: фон
второй: второй втора
поверилось: повериться
лишь: лишь
мельком: мельком
обошлось: обойтись
потерь: потеря
среди: среди
одному: один
очень: очень
симпатизировала: симпатизировать
т: так то т
большинство: большинство
основных: основный основной
персонажей: персонаж
доживут: дожить
последних: последний
страниц: страница
труда: труд
некоторые: некоторый некоторые
познают: познавать познать
самую: самый
главную: главный
силу: сила сило
изначально: изначально изначальный
строилась: строиться
хара: хара
дом: дом
порадовало: порадовать
нэсс: нэсса
каждой: каждый
битве: битва
героем: герой
весьма: весьма
забавно: забавно забавный
учитывая: учитывать
споры: спор спорый спора
шеном: шеном шенома шеный шёный шен
той: тот той
части: часть частить
повоюет: повоевать
наш: наш
любимый: любимый любить
гиян: гиян гиять
касается: касаться
окончания: окончание
думала: думать
честно: честно честный
результаты: результат
ярко: ярко яркий
выраженные: выраженный выразить
вышло: выйти
правдоподобнее: правдоподобный
представлялось: представляться
немало: немало немалый
провалов: провал
прошлое: прошлое прошлый
позволило: позволить
ещё: ещё
сблизиться: сблизиться
героями: герой
например: например
начала: начало начать
сочувствовать: сочувствовать
тиф: тиф
уменьшало: уменьшать
динамичности: динамичность
наверное: наверное
практически: практически
бытовых: бытовой
мелочей: мелочь
результате: результат
книге: книга
захвачен: захватить
довольно: довольно довольный
большой: большой
временной: временной временный
период: период
какие: какой
разгаданы: разгадать
тайны: тайна тайный
думаете: думать
знаете: знать знаете
секреты: секрет
лаэн: лаэн
хехехе: хехех хехёха
автору: автор
найдется: найтись
удивить: удивить
думаю: думать
интересовал: интересовать
предположения: предположение
развеялось: развеяться
середине: середина
второе: второе второй
оказалось: оказаться
созвучно: созвучно созвучный
предположением: предположение
нэсса: нэссать нэсс
верно: верно верный
узнаете: узнать узнавать
самом: сам самый
деле: дело
подумали: подумать
красиво: красиво красивый
спасена: спасти
крайней: крайний
мере: мера меря
появился: появиться
никакой: никакой
шанс: шанс
надеюсь: надеяться
удалось: удаться
запутать: запутать
меньше: маленький
наспойлерить: наспойлерить
опции: опция
пожаловаться: пожаловаться
открыть: открыть
новом: новый новое
окне: окно
поделиться: поделиться
вконтакте: вконтакте
твиттер: твиттер
одноклассники: одноклассник
мир: мир миро
полезная: полезный
рецензия: рецензия
добавить: добавить
комментарий: комментарий
июля: июль
оценка: оценка
люблю: любить
пехова: пехов
наткнулась: наткнуться
кажется: казаться кажется
рекомендациях: рекомендация
общем: общий
взахлеб: взахлёб
прочитала: прочитать
смогла: смочь
опишу: описать
пожалуй: пожалуй пожаловать
свое: свой
впечатление: впечатление
серии: серия
помимо: помимо
моей: мой
серию: серия
первой: первый
читатели: читатель
оставляли: оставлять
рекомендую: рекомендовать
ознакомиться: ознакомиться
ними: они
искатели: искатель
ибо: ибо
мнения: мнение
расходятся: расходиться
вкус: вкус
цвет: цвет цвета
фломастеры: фломастер
разные: разный
разряда: разряд
типичного: типичный
фентези: фентези
такое: такой
слегка: слегка
уменьшает: уменьшать
шансы: шанс
вспоминать: вспоминать
списке: список
“: “
всей: весь всеять
жизни: жизнь
читается: читаться
равне: равне равна равень равний
рецензентами: рецензент
сравню: сравнить
хрониками: хроника хроник
сиалы: сиалы сиала сиалый сиал
хрониках: хроника хроник
основной: основной основный
персонаж: персонаж
остальные: остальной
третьестепенные: третьестепенный
главные: главный главное
персонажи: персонаж
раскрыты: раскрыть
собственно: собственно собственный
понравилось: понравиться
верхушки: верхушка
обоих: оба
лагерей: лагерь
интриги: интрига
расписаны: расписать
просто: просто простой
стильненько: стильненький стильненек стильненько
общепринятые: общепринятый
злодеи: злодей
напомнили: напомнить
хроники: хроника хроник
черного: чёрный
отряда: отряд
первых: первый первое
книгах: книга
понравились: понравиться
отсылки: отсылка
чему: что
большему: больший
доходило: доходить
фейспалма: фейспалма
сдержанней: сдержанный
введенные: ввести
чистые: чистый
душой: душа
типа: тип типа
шена: сить шеный шёный шен
одной: один
девушки: девушка
учетом: учёт
последующих: последующий
действий: действие
решений: решение
раздражали: раздражать
безмерно: безмерно безмерный
ладно: ладный ладно
идиот: идиот
которому: который
такими: такой
взглядами: взгляд
таких: такой
условиях: условие
выжить: выжить
реально: реально реальный
портит: портить
картину: картина
зато: зато
корыстные: корыстный
плохие: плохой
выглядят: выглядеть
действиях: действие
прослеживается: прослеживаться
логика: логика логик
почитать: почитать
отдохнуть: отдохнуть
читала: читать
дважды: дважды
чтение: чтение
легкой: лёгкий
ненавязчивой: ненавязчивый
литературы: литература
позволяет: позволять
моему: мой
мозгу: мозг
нагененрировать: нагененрировать
ярких: яркий
картинок: картинка
голове: голова голов
заумного: заумный
творить: творить
работе: работа
тайные: тайный
сокровища: сокровище
ридли: ридлить ридли
показать: показать
друзьями: друг
изменить: изменить
информацию: информация
лучшие: хороший
топ: топ
танец: танец
драконами: дракон
пятно: пятно
созданиях: создание
больших: больший большой
малых: малый малое
случай: случай случать
интернате: интернат
весь: весь весить
редактирование: редактирование
информации: информация
спасибо: спасибо
помогаете: помогать
делать: делать
сайт: сайт
экранизацию: экранизация
отправить: отправить
ваше: ваш
сообщение: сообщение
отправлено: отправить
нам: мы
стать: стать
рассмотрено: рассмотреть
нашими: наш
специалистами: специалист
самое: самый сам
ближайшее: близкий
гарри: гарри
поттер: поттер
орден: орден
феникса: феникс
помощь: помощь
закрыть: закрыть
хочу: хотеть
прочитать: прочитать
читаю: читать
прочитал: прочитать
печатное: печатный
издание: издание
аудиокнигу: аудиокнига
электронную: электронный
версию: версия
оригинальном: оригинальный
языке: язык
избранное: избранный избрать
подписаться: подписаться
оценить: оценить
заметку: заметка
полку: полка полк полок
создать: создать
хотите: хотеть
удалить: удалить
летнаяя: летнаять
полка: полка полок полк
которые: который
дочитал: дочитать
друзей: друг
флешмоб: флешмоб
личностного: личностный
роста: рост
детям: ребёнок
ночь: ночь
коллекция: коллекция
добавление: добавление
удаление: удаление
поставить: поставить
оценку: оценка
средняя: средний
вероятно: вероятно вероятный
оцените: оценить
сохранено: сохранить
июль: июль
август: август августа
убрать: убрать
сохранить: сохранить
заметки: заметка
удобный: удобный
простой: простой простоять
способ: способ
хранить: хранить
нужную: нужный
мысли: мысль мыслить
личного: личный личной
использования: использование
ваша: ваш
заметка: заметка
видна: видный
